#######################################
# Syntax Coloring Map For LEDMatrix
#######################################

#######################################
# Datatypes (KEYWORD1)
#######################################
cLEDMatrix	KEYWORD1
cLEDMatrixBase	KEYWORD1
CRGB	KEYWORD1

#######################################
# Methods and Functions (KEYWORD2)
#######################################
Width	KEYWORD2
VerticalMirror	KEYWORD2
TriangleTopMirror	KEYWORD2
TriangleBottomMirror	KEYWORD2
Size	KEYWORD2
showColor	KEYWORD2
show	KEYWORD2
SetLEDArray	KEYWORD2
setBrightness	KEYWORD2
QuadrantTopTriangle	KEYWORD2
QuadrantMirror	KEYWORD2
QuadrantBottomTriang	KEYWORD2
mXY	KEYWORD2
HorizontalMirror	KEYWORD2
Height	KEYWORD2
getPixel	KEYWORD2
getPixelIndex	KEYWORD2
fillScreen	KEYWORD2
fadeAll	KEYWORD2
drawTriangle	KEYWORD2
drawRoundRect	KEYWORD2
drawRectangle	KEYWORD2
drawPixel	KEYWORD2
drawLine	KEYWORD2
drawFillRoundRect	KEYWORD2
drawFilledTriangle	KEYWORD2
drawFilledRectangle	KEYWORD2
drawFilledCircle	KEYWORD2
drawFastVLine	KEYWORD2
drawFastHLine	KEYWORD2
drawCircleHelper	KEYWORD2
drawCircle	KEYWORD2
clear	KEYWORD2

#######################################
# Constants (LITERAL1)
#######################################
VERT_DIR	LITERAL1
TOP_DOWN	LITERAL1
TILES_IN_MATRIX	LITERAL1
TEENSY_TRANS	LITERAL1
STRIPS_PER_BANK	LITERAL1
SPI_MHZ	LITERAL1
RIGHT_2_LEFT	LITERAL1
refresh_fps	LITERAL1
NUM_STRIPS	LITERAL1
NUM_STRIPS	LITERAL1
NUM_LEDS_CALC	LITERAL1
NUM_LEDS	LITERAL1
NUM_BANKS	LITERAL1
NUM_BANKS	LITERAL1
MATRIX_WIDTH_DIR	LITERAL1
MATRIX_WIDTH_DIR	LITERAL1
MATRIX_WIDTH	LITERAL1
MATRIX_TYPE	LITERAL1
MATRIX_TILE_WIDTH	LITERAL1
MATRIX_TILE_V_DIR	LITERAL1
MATRIX_TILE_V_DIR	LITERAL1
MATRIX_TILE_V	LITERAL1
MATRIX_TILE_HEIGHT	LITERAL1
MATRIX_TILE_H_DIR	LITERAL1
MATRIX_TILE_H_DIR	LITERAL1
MATRIX_TILE_H	LITERAL1
MATRIX_HEIGHT_DIR	LITERAL1
MATRIX_HEIGHT_DIR	LITERAL1
MATRIX_HEIGHT	LITERAL1
LEFT_2_RIGHT	LITERAL1
LEDS_PER_STRIP	LITERAL1
LEDS_PER_BANK	LITERAL1
LEDS_IN_TILE	LITERAL1
HORIZ_DIR	LITERAL1
HAS_BANKS	LITERAL1
HAS_TILES	LITERAL1
FASTLED_TEENSY4	LITERAL1
FASTLED_TEENSY3	LITERAL1
DATA_2	LITERAL1
DATA_2	LITERAL1
DATA_1	LITERAL1
DATA_1	LITERAL1
CORRECTION	LITERAL1
COLOR_ORDER	LITERAL1
CLOCK_2	LITERAL1
CLOCK_2	LITERAL1
CLOCK_1	LITERAL1
CLOCK_1	LITERAL1
CHIPSET	LITERAL1
BRIGHTNESS	LITERAL1
BOTTOM_UP	LITERAL1
BANK_PIN_3	LITERAL1
BANK_PIN_3	LITERAL1
BANK_PIN_2	LITERAL1
BANK_PIN_2	LITERAL1
BANK_PIN_1	LITERAL1
BANK_PIN_1	LITERAL1
BANK_PIN_0	LITERAL1
BANK_PIN_0	LITERAL1
matrixWidth	LITERAL1
matriHeight	LITERAL1
matrixType	LITERAL1
ledHorizDir	LITERAL1
ledVertDir	LITERAL1
tileWidth	LITERAL1
tileHeight	LITERAL1
tilesPerRow	LITERAL1
tilesPerCol	LITERAL1
tileLedsFlow	LITERAL1
tileFlow	LITERAL1
numBanks	LITERAL1
stripsPerBank	LITERAL1
ledsPerBank	LITERAL1
ledsPerStrip	LITERAL


